11111
100E1
10001
1P0C1
11111
